CREATE TABLE HISTORICO_UROANALISIS
(
HIST_ID_UROANALISIS	int,
HIST_RECORDS_UROANALISIS varchar(7),
HIST_CANTIDAD varchar(10),
HIST_ASPECTO varchar(10),
HIST_OLOR varchar(15),
HIST_COLOR varchar(10),
HIST_PH	varchar(10),
HIST_DENSIDAD	varchar(15),
HIST_Q_ALBUMINA	varchar(10),
HIST_Q_GLUCOSA	varchar(10),
HIST_Q_SANGREOCULTA	varchar(10),
HIST_Q_UROBILINGENO	varchar(10),
HIST_Q_BILIRRUBINA varchar(10),
HIST_Q_CETONA varchar(10),
HIST_M_LEUCOCITOS varchar(10),
HIST_M_HEMATIES	varchar(10),
HIST_M_BACTERIAS varchar(10),
HIST_M_TRICHOMONAS varchar(10),
HIST_M_CILINDROSGRANULOSOS varchar(10),
HIST_M_CILINDROSHIALINOS varchar(10),
HIST_M_EPITELIOS varchar(10),
HIST_M_FIBRASMUCOSAS varchar(10),
HIST_M_CRISTALES varchar(10),
HIST_M_UCG varchar(10),
HIST_NOMB_MEDICO varchar(25),
HIST_FECHA varchar(15)
)
CREATE TABLE HISTORICO_SEROLOGIA
(
HIST_ID_SEROLOGIA int,
HIST_RECORDS_SEROLOGIA varchar(7),
HIST_TOSOPLASMOSIS	varchar(1),
HIST_HIV	varchar(1),
HIST_Ag_ASTRALIANO	varchar(1),
HIST_STREPTOZINE	varchar(1),
HIST_FACTORREUMATOIDE	varchar(1),
HIST_PROTEINAScREACTIVAS	varchar(1),
HIST_HCG	varchar(1),
HIST_TESTCOMBS	varchar(1),
HIST_ASO	varchar(10),
HIST_VDLR	varchar(15),
HIST_NOMBRE_OTROS	varchar(10),
HIST_VALOR_OTROS	varchar(15),
HIST_NOMBRE_MEDICO	varchar(25),
HIST_FECHA	datetime
)

CREATE TABLE HISTORICO_QUIMICA_CLINICA
(
HIST_ID_QUIMICACLINICA	int,
HIST_RECORDS_QUIMICACLINICA	varchar(7),
HIST_GLUCOSA	varchar(15),
HIST_U_GLUCOSA	varchar(10),
HIST_VN_GLUCOSA	varchar(10),
HIST_UREA	varchar(15),
HIST_U_UREA	varchar(10),
HIST_VN_UREA	varchar(10),
HIST_CREATINA	varchar(15),
HIST_U_CREATINA	varchar(10),
HIST_VN_CREATINA	varchar(10),
HIST_ACIDOURICO	varchar(15),
HIST_U_ACIDOURICO	varchar(10),
HIST_VN_ACIDOURICO	varchar(10),
HIST_BILIRRUBINATOTAL	varchar(15),
HIST_U_BILIRRUBINATOTAL	varchar(10),
HIST_VN_BILIRRUBINA	varchar(10),
HIST_BILIRRUBINA_DIRECTA	varchar(15),
HIST_U_BILIRRUBINA_DIRECTA	varchar(10),
HIST_VN_BILIRRUBINA_DIRECTA	varchar(10),
HIST_BILIRRUBINA_INDIRECTA	varchar(15),
HIST_U_BILIRRUBINA_INDIRECTA	varchar(10),
HIST_VN_BILIRRUBINA_INDIRECTA	varchar(10),
HIST_BILIRRUBINA_TOTALES	varchar(10),
HIST_ALBUMINA	varchar(15),
HIST_U_ALBUMINAS	varchar(10),
HIST_VN_ALBUMINAS	varchar(10),
HIST_GLOBOLINA	varchar(15),
HIST_U_GLOBULINA	varchar(10),
HIST_VN_GLOBULINA	varchar(10),
HIST_RELACION_AG	varchar(15),
HIST_U_RELACION_AG	varchar(10),
HIST_VN_RELACION_AG	varchar(10),
HIST_COLESTEROL	varchar(15),
HIST_U_COLESTEROL	varchar(10),
HIST_VN_COLESTEROL	varchar(10),
HIST_TRIGLICERIDOS	varchar(15),
HIST_U_TRIGLICERIDOS	varchar(10),
HIST_VN_TRIGLICERIDOS	varchar(10),
HIST_TGO	varchar(15),
HIST_U_TGO	varchar(10),
HIST_VN_TGO	varchar(10),
HIST_TGP	varchar(15),
HIST_U_TGP	varchar(10),
HIST_VN_TGP	varchar(10),
HIST_NOMBRE_OTROS_QC	varchar(15),
HIST_U_OTROS_QC	varchar(10),
HIST_VN_OTROS_QC	varchar(10),
HIST_NOMB_MEDICO	varchar(25),
HIST_FECHA	datetime
)
CREATE TABLE HISTORICO_HEMATOLOGIA
(
HIST_ID_HEMATOLOGIA	int IDENTITY,
HIST_RECORDS_HEMATOLOGIA	varchar(7),
HIST_HEMATIES	varchar(15),
HIST_HEMOGLOBINA	varchar(15),
HIST_HEMATOCRITO	varchar(15),
HIST_INDICE_VCM	varchar(15),
HIST_U3HCM	varchar(15),
HIST_UUgr	varchar(15),
HIST_LEUCOPTOS	varchar(15),
HIST_CHCM	varchar(15),
HIST_METAMIELO	varchar(10),
HIST_BANDAS	varchar(10),
HIST_SEGMENTACION	varchar(10),
HIST_ECONOFILOS	varchar(10),
HIST_BACTERIAS	varchar(10),
HIST_LINFOCITOS	varchar(10),
HIST_MONOCITOS	varchar(10),
HIST_TIPIF_GRUPO	varchar(3),
HIST_TIPIF_Rh	varchar(3),
HIST_PLAQUETAS	varchar(10),
HIST_VN	varchar(10),
HIST_TCOAGULANTES	varchar(10),
HIST_TSANGRIA	varchar(10),
HIST_ERITROSED	varchar(10),
HIST_MM1hVN	varchar(10),
HIST_FALCEMIA	varchar(10),
HIST_GOTAGRUESA	varchar(10),
HIST_NOMB_MEDICO	varchar(25),
HIST_FECHA	DATETIME,
PRIMARY KEY(HIST_ID_HEMATOLOGIA)
)

CREATE TABLE HISTORICO_PARASITOLOGIA
(
HIST_ID_PARASITOLOGIA int IDENTITY,
HIST_RECORDS_PARASITOLOGIA	varchar(7),
HIST_ELEMENTOSPARASITOS	varchar(1),
HIST_ENTAMOEBAHISTOLICA	varchar(15),
HIST_GIARDIALAMBIA	varchar(15),
HIST_HYMENOLEPSIS	varchar(15),
HIST_ASCARISLUMBRICOIDE	varchar(15),
HIST_TRICHURIS	varchar(15),
HIST_UNCINARIAS	varchar(15),
HIST_OTROS_NOMBRE	varchar(10),
HIST_OTROS_DESCRIBA	varchar(15),
HIST_NOMB_MEDICO	varchar(25),
HIST_FECHA datetime,
PRIMARY KEY(HIST_ID_PARASITOLOGIA)
)	

CREATE TABLE SEROLOGIA
(
ID_SEROLOGIA	int IDENTITY,
ID_RECORDS_SEROLOGIA	varchar(7),
TOSOPLASMOSIS	varchar(1),
HIV	varchar(1),
Ag_ASTRALIANO	varchar(1),
STREPTOZINE	varchar(1),
FACTORREUMATOIDE	varchar(1),
PROTEINAScREACTIVAS	varchar(1),
HCG	varchar(1),
TESTCOMBS varchar(1),
ASO	varchar(10),
VDLR	varchar(15),
NOMBRE_OTRO	varchar(10),
VALOR_OTROS varchar(15),
NOMBRE_MEDICO	varchar(25),
FECHA	datetime,
PRIMARY KEY(ID_RECORDS_SEROLOGIA)
)
CREATE TABLE PARASITOLOGIA
(
ID_RECORDS_PARASITOLOGIA	varchar(7) NOT NULL,
ID_PARASITOLOGIA int IDENTITY,
ELEMENTOSPARASITOS	varchar(1),
ENTAMOEBAHISTOLICA	varchar(15),
GIARDIALAMBIA	varchar(15),
HYMENOLEPSIS	varchar(15),
ASCARISLUMBRICOIDE	varchar(15),
TRICHURIS	varchar(15),
UNCINARIAS	varchar(15),
OTROS_NOMBRE	varchar(10),
OTROS_DESCRIBA	varchar(15),
NOMB_MEDICO	varchar(25),
FECHA	datetime
PRIMARY KEY(ID_RECORDS_PARASITOLOGIA)
)
